111111111111
100010CCCC01
100001110001
1P0011E00101
100000000101
111111111111