111111111
111111111
111111111
111111111
111111111
1P1C1E111
101000111
1001000C1
110111011
100110011
1011100C1
100110111
110110111
100110011
101C01001
100101101
110100001
100001101
1C1C11C01
111111111
