1111111111111111111111
100010CCCC000000000001
10000111100000000000011
1P00110000000000000111
10000000000000000001E1
1111111111111111111111