111111111111
100010CCCC01
100001111010
1P0011E00001
111111111111
